........
....W...
....N.F.
....W...
..F.....
..W.....
.F......
........