.......F
.W.W....
.W.W....
.W.W....
.W.W....
.W.W....
.W.W....
........