..........
...W......
....W.....
...W......
.F........
..........
..........
.W........
...F......
..........
