..........
.W........
...W......
.W.W......
....F.....
..F.......
..........
....W.....
..........
..........